########################################
#.........#..................#.........#
#.........#..................#.........#
#.........#..................#.........#
#....###########........###########....#
#......................................#
#......................................#
#......................................#
#......................................#
#^^^^..........##########..........^^^^#
#......................................#
#......................................#
#......................................#
#......................................#
#^^^^^^^^^####################^^^^^^^^^#
#..............#........#..............#
#..............#........#..............#
#..............#........#..............#
#..............#........#..............#
#....^^^^^.....#........#.....^^^^^....#
#......................................#
#......................................#
#......................................#
#..T................................T..#
######....######........######....######
#......................................#
#......................................#
#......................................#
#P.....T.........T....T.........T.....P#
########################################
