########################################
#......................................#
#......................................#
#......................................#
######.........##########.........######
#......................................#
#......................................#
#......................................#
#......................................#
######^^^^^^^^^##########^^^^^^^^^######
#......................................#
#......................................#
#......................................#
#......................................#
#....^^^^^####################^^^^^....#
#......................................#
#......................................#
#......................................#
#......................................#
#....^^^^^....................^^^^^....#
#......................................#
#......................................#
#......................................#
#.T..................................T.#
#^^^^##############################^^^^#
#......................................#
#......................................#
#......................................#
#P....................................P#
########################################
