########################################
#......................................#
#......................................#
#......................................#
################........################
#....#............................#....#
#....#............................#....#
#....#............................#....#
#....#............................#....#
#....#....####################....#....#
#.........#..................#.........#
#.........#..................#.........#
#.........#..................#.........#
#.........#..................#.........#
#^^^^#....#..................#....#^^^^#
#....#....#..................#....#....#
#....#....#..................#....#....#
#....#....#..................#....#....#
#....#.T..#..................#..T.#....#
#^^^^#^^^^#^^^^^^^^^^^^^^^^^^#^^^^#^^^^#
#....#............................#....#
#....#............................#....#
#....#............................#....#
#....#............................#....#
#....#^^^^^^^^^^^^^^^^^^^^^^^^^^^^#....#
#......................................#
#......................................#
#......................................#
#PT..................................TP#
########################################
