########################################
#......................................#
#......................................#
#......................................#
#..............##########..............#
#......................................#
#......................................#
#......................................#
#......................................#
#^^^^^^^^^^^^^^##########^^^^^^^^^^^^^^#
#......................................#
#......................................#
#......................................#
#......................................#
######^^^^.....#........#.....^^^^######
#..............#........#..............#
#..............#........#..............#
#..............#........#..............#
#............T.#........#.T............#
#....##############################....#
#.........#..................#.........#
#.........#..................#.........#
#.........#..................#.........#
#.........#..................#.........#
#....######....#........#....######....#
#..............#........#..............#
#..............#........#..............#
#..............#........#..............#
#PT............#........#............TP#
########################################
