########################################
#......................................#
#......................................#
#......................................#
#.........#..................#.........#
#.........#..................#.........#
#.........#..................#.........#
#.........#..................#.........#
#.........#..................#.........#
#....##############################....#
#.........#..................#.........#
#.........#..................#.........#
#.........#..................#.........#
#..T......#..................#......T..#
#^^^^.....#..................#.....^^^^#
#......................................#
#......................................#
#......................................#
#......................................#
#....#....^^H^^^^^^^^^^^^^^H^^....#....#
#....#......H..............H......#....#
#....#......H..............H......#....#
#....#......H..............H......#....#
#..T.#.T....H..............H....T.#.T..#
######^^^^..H..............H..^^^^######
#...........H..............H...........#
#...........H..............H...........#
#...........H..............H...........#
#P..........H....T....T....H..........P#
########################################
