########################################
#......................................#
#......................................#
#......................................#
######....######........######....######
#......................................#
#......................................#
#......................................#
#......................................#
###########....##########....###########
#......................................#
#......................................#
#......................................#
#......................................#
######....####################....######
#.........#..................#.........#
#.........#..................#.........#
#.........#..................#.........#
#.........#..................#.........#
######^^^^#....#........#....#^^^^######
#..............#........#..............#
#..............#........#..............#
#..............#........#..............#
#..............#........#..............#
######^^^^^^^^^#^^^^^^^^#^^^^^^^^^######
#......................................#
#......................................#
#......................................#
#P....................................P#
########################################
