########################################
#..............#........#..............#
#..............#........#..............#
#..............#........#..............#
###########....#........#....###########
#..............#........#..............#
#..............#........#..............#
#..............#........#..............#
#..............#........#..............#
#.........#^^^^#^^^^^^^^#^^^^#.........#
#.........#..................#.........#
#.........#..................#.........#
#.........#..................#.........#
#.........#..................#.........#
######....####################....######
#....#.........#........#.........#....#
#....#.........#........#.........#....#
#....#.........#........#.........#....#
#....#..T......#........#......T..#....#
#....#^^^^#....#........#....#^^^^#....#
#....#....#..................#....#....#
#....#....#..................#....#....#
#....#....#..................#....#....#
#....#....#..................#....#....#
#^^^^#^^^^######^^^^^^^^######^^^^#^^^^#
#.........#..................#.........#
#.........#..................#.........#
#.........#..................#.........#
#P........#..................#........P#
########################################
