########################################
#.........#..................#.........#
#.........#..................#.........#
#.........#..................#.........#
#....#....#....##########....#....#....#
#....#....#..................#....#....#
#....#....#..................#....#....#
#....#....#..................#....#....#
#....#....#..................#....#....#
######^^^^#^^^^##########^^^^#^^^^######
#..............#........#..............#
#..............#........#..............#
#..............#........#..............#
#..............#........#..............#
######^^^^^^^^^#........#^^^^^^^^^######
#..............#........#..............#
#..............#........#..............#
#..............#........#..............#
#..............#........#..............#
#....######^^^^#^^^^^^^^#^^^^######....#
#....#....#..................#....#....#
#....#....#..................#....#....#
#....#....#..................#....#....#
#....#....#..................#....#....#
######....#....#^^^^^^^^#....#....######
#..............#........#..............#
#..............#........#..............#
#..............#........#..............#
#P..........T..#........#..T..........P#
########################################
