########################################
#......................................#
#......................................#
#......................................#
######....#....##########....#....######
#.........#..................#.........#
#.........#..................#.........#
#.........#..................#.........#
#.........#..................#.........#
######^^^^#^^^^##########^^^^#^^^^######
#....#.........#........#.........#....#
#....#.........#........#.........#....#
#....#.........#........#.........#....#
#....#.........#........#.........#....#
#....#....######........######....#....#
#.........#..................#.........#
#.........#..................#.........#
#.........#..................#.........#
#......T..#..................#..T......#
#^^^^######....##########....######^^^^#
#......................................#
#......................................#
#......................................#
#......................................#
#^^^^######^^^^##########^^^^######^^^^#
#......................................#
#......................................#
#......................................#
#P....................................P#
########################################
