#################################
#...............................#
#...............................#
#...............................#
#...............................#
#...............................#
#...............................#
#...............................#
#.P...........................P.#
#################################
