########################################
#......................................#
#......................................#
#......................................#
#......................................#
#..........T................T..........#
#..^^###########........###########^^..#
#....#.........#^^....^^#.........#....#
#....#.........#........#.........#....#
#..^^#.........#........#.........#^^..#
#....#.........#^^....^^#.........#....#
#....#.........#........#.........#....#
#..^^#.........#........#.........#^^..#
#....#.........#^^....^^#.........#....#
#....#.........#........#.........#....#
#..^^#.........#........#.........#^^..#
#....#.........#^^....^^#.........#....#
#....#.........#........#.........#....#
#..^^#.........#........#.........#^^..#
#....#.........#^^....^^#.........#....#
#....#.........#........#.........#....#
#..^^#.........#........#.........#^^..#
#....#.........##########.........#....#
#....#............................#....#
#..^^#............................#^^..#
#....#............................#....#
#P...#............................#...P#
######............................######
#......................................#
#......................................#
