########################################
#......................................#
#......................................#
#......................................#
#......................................#
#......................................#
#..............##########..............#
#..............#........#..............#
#............^^#........#^^............#
#..............#........#..............#
#..............#........#..............#
#P...........^^#........#^^...........P#
######.........#........#.........######
#....#.........#........#.........#....#
#....#.......^^#........#^^.......#....#
#....#T........#........#........T#....#
#....######....#........#....######....#
#.........#^^^^#........#^^^^#.........#
#.........#....#........#....#.........#
#.........#....#........#....#.........#
#.........#^^^^#........#^^^^#.........#
#.........#....#........#....#.........#
#.........#....#........#....#.........#
#.........#^^^^#........#^^^^#.........#
#.........#....#........#....#.........#
#.........#....#........#....#.........#
#.........######........######.........#
#......................................#
#......................................#
#......................................#
