########################################
#......................................#
#......................................#
#......................................#
#......................................#
#.........######^^....^^######.........#
#.........#....#........#....#.........#
#.......^^#....#........#....#^^.......#
#.........#....#^^....^^#....#.........#
#.........#....#........#....#.........#
#.......^^#....#........#....#^^.......#
#.........#....#^^....^^#....#.........#
#.........#....#........#....#.........#
#.......^^#....#........#....#^^.......#
#.........#....#^^....^^#....#.........#
#.........#....#........#....#.........#
#P......^^#....#........#....#^^......P#
######....#....#^^....^^#....#....######
#....#....#....#........#....#....#....#
#....#..^^#....#........#....#^^..#....#
#....#....#....#^^....^^#....#....#....#
#....#....#....#........#....#....#....#
#....#..^^#....#........#....#^^..#....#
#....#....#....##########....#....#....#
#....#T...#..................#...T#....#
#....######..................######....#
#......................................#
#......................................#
#......................................#
#......................................#
