########################################
#......................................#
#......................................#
#......................................#
#......................................#
#P....................................P#
######^^........................^^######
#....#............................#....#
#....#............................#....#
#....#^^........................^^#....#
#....#............................#....#
#....#............................#....#
#....#^^^^######........######^^^^#....#
#....#....#....#^^....^^#....#....#....#
#....#....#....#........#....#....#....#
#....#^^^^#....#........#....#^^^^#....#
#....#....#....##########....#....#....#
#....#....#..................#....#....#
#....######..................######....#
#......................................#
#......................................#
#......................................#
#......................................#
#......................................#
#......................................#
#......................................#
#......................................#
#......................................#
#......................................#
#......................................#
