########################################
#......................................#
#......................................#
#......................................#
#......................................#
#..............##########..............#
#............^^#........#^^............#
#..^^######....#........#....######^^..#
#....#....#....#........#....#....#....#
#P...#....#^^^^#........#^^^^#....#...P#
######....#....#........#....#....######
#.........#....#........#....#.........#
#.........#^^^^#........#^^^^#.........#
#.........#....#........#....#.........#
#.........#....#........#....#.........#
#.........#^^^^#........#^^^^#.........#
#.........#....#........#....#.........#
#.........#....#........#....#.........#
#.........#^^^^#........#^^^^#.........#
#.........#....#........#....#.........#
#.........#....#........#....#.........#
#.........#^^^^#........#^^^^#.........#
#.........#....#........#....#.........#
#.........#....#........#....#.........#
#.........#^^^^#........#^^^^#.........#
#.........#....#........#....#.........#
#.........#....#........#....#.........#
#.........######........######.........#
#......................................#
#......................................#
